119,15
5,150
14,83
92,119
6,26
31,40
15,98
38,69
119,43
8,42
011110001010011011010111011010111101011111101111010101111111111101111111111111111111111101111111111a101111110001111110010111111111110111100111111111010110101011
111010111001111110101111010111111011011111111111111111111101001111011111010111111101101101111111111a101100011001111111111000101011111111111111110111001101111111
111001011111111011111111111111011110101101111111110101011111111111111111101100111111100111111100101a111111001111010110011111011111011111011010101111110111011111
110111011111111011110111101100111111111010111111111111101111111111101011111111101111100011111000100a110111111110111101110111111101111111110111011111110101111111
110011111111111111001111110011111101111111000110111111110111101011111011111111110111111011011011111a111110011011101100110111111111001111111111011101111101011111
100111111111110110111111111101110111111111110011111101111111101110111011111011111111111101111011111a101111111111110111110111101111111111111010100111111111110011
111011111111110101111111111110101010111110001110111111110111101111111111111011111111101101111111110a011111110111111101111101111111111111111011110011101111110111
111111111111110101111111010111011110100111111111110010011110111011111111111001111011110111111111111a110111101110110111110011111010111111111111111110010111111111
101111010011111111111110101001110111001111111101111111111101111011111100111001100101111111101110111a010111010100110111111101110011101111110111001011101100111111
111111111111101111111111011111011101111111101110111111111111001111101110111111000111111011110101111a110111001111101111111101101110111111101111110111101110111110
111111111111111010111111111111111101100101111110111010111101110011101111110111111011111111111111111a111111111111111111111001111111100011111110110111111111010100
210112122211121202122211111111111110110101101111110111011011101001101010100111011111111111011111011a011011111111111111110111111111111111111101111111011111111111
211221002211201222120211111111111101111110101111111111111111110011111101111101111101011111111110011a111111111111110111101110111111101111111111011101111000111111
101211202222202212111201111111011101111111111111111011110111100111111111110011111111111110111101111a111111001101111111100011111111011101111111111111101110111100
211112111021212011210211111011111111111111011111111011011111011111111110111011101001111111101110111a111111111011101111011111111111111111011111101111011111110010
112021101011012211010111011111111111111111111010011111011111111111111100110101101100111111111101101a111111111111111111111111111111111111100111111110010101100101
222122022202122210001101111111111111111101111111111111101111111011110100101111011111011001111011111a111111110111111111011111111111101011111011111111110111111110
111001112010022121221011111111011111111011111111111110011111001111011111111111111111101111111110101a101110111111111100011101011111111010011111111111111101110111
212200122110112222201111111111011111110111111101111111111111111101111111111111101111111111101111111a000101111010011011101111111111111110111101100111111111011101
222110201220220221121000111111111101110110110101111011011111111011110110111000111111111010101110011a011111111111111110111111110011111111001111100111101111111111
111221210201122211212011101011110101111111110110111110011111111111110011111111111111101111111000101a10011111101111100111111010111111111011111111111111001100111
111111011000111111011211111111111100110110111111111010111011011111101011000101100111110101101111101a111110111101111111111001100101111010111111100111111011111111
201201211221220222220001111111011111111011111111101111111111101110011111111111101101111111111111111a111101011111111111111111111110110111111100111111111111110111
122101102122021221201111011111101100111111111101101111010111110011111101111001101100111111110101111a111111011111111111111111011111111110111111111011110111111111
021222202211211221210101111111100111111011111110111101101111111101111111111111101111111111011101010a110111111110111111010100111111111110111111111101111110111111
021121121122201211121112111122110101212211211221111101111111110111111111101111011111111111111111111a101111111111111111011101011111011111010111111101111111111111
012122112222221222121211102211112110121110211001111111110011111001111011011011111111111111011010111a111111101111111001111111111011111111011111111100101001111111
020011202010012102221222212012102212212101012121111111111111011110111111111111111110111111111111111a000101011111111111011110110111101111010111101111110110001110
121210222222221100221122102001222010212112212220111111111111110101111110011111111110111011101111111a111110122201220201011211102002012211111110110110111101101101
201202011021022120220121020022220110120111210121011111111111101011110111111111111111111111111101100a011121112112111122122220222112222210110111010011111111101100
222220212202212222021202112212101012101102212121011111011111110111011111011100100101010010101001000a111101210201202122221102121111101121101011111111110101111111
111110011111111011101011111110111110011000211120011111011101111111110011111111000111101001011111101a111112022000221102111222212221110221011111011111111111110100
111011111101101101101111011110011111111111010101110100101111101111111111010111111111111111111111110a111101011011101111111121001020011211111110111111111100111111
210221221121222221021222222212202122212212020221111111111111111010111011111110110111110101111110111a011110202012122122221210211202221221101111111111101110111111
222222221222021220201222121112211211020211011220011111011101111010111111111111111111110111101111111a111022121222111122001110221110120211011111111011111110111111
111110111111111110110222022210200212102210110101111111011111111110011100111111111111111110011111111a111121210102211112211212211011011210110111111111101011110111
200222020012112220221220100221201000112210220210111111101011111011111110111111101111111111111111111a111122112021211211210111201210201201111101111111011111111101
202220122202022122211222011200200021121011112211101111110111100011111111110111100011111111010101111a101111111100110111111001011111111111111110011111101111011010
220022222222000222201212122112122120102210122120110111011111111101111111001101111001111111011111111a110122012120221000111112100121021110110111110111111111111111
011211202222021022221200211122122101120111120101111011111111011111111111111111011111101111110111100a111100011221221211100222110020111210111001111111100011101111
202211122021212222021002201012222211211210201211101110100111111111011101101111011111011001111111111a111012012222222122101110220011200110110111101110111101011001
212112112022022220220222112212120021100200222021111111101111111011111011111011101110110111101111110a111122202100020220021111222201220201111111111100111111111111
012211220110202000021202122211112201211212101221111101111111110111001101110111111111101111111111111a111112021122212111110201122221221111111111110111011101100111
101111221201102110211222120221202020212212012021101111011111111011100111111101011100111011111111110a011121210212121210111211220122221011111001011010101101110011
221122101022222202211212211102211222022112122121101111110101011111111111111111111011111111111111110a110112212111212021111022221012022111010011101111111011101010
bbabbabbabaaabbbaaabb020212122222211100102120121111111011111100111010111110111111111111101110111111a011122122002200000221110111121121021101111111111101110110101
12220022112222122222b212202122020112221012102021010010111111110111111111001111011011111101111001111a111121120220211022221222002201220211110110111101111011111111
22221211212021002210b222221120010210010112220020110111111111111010011111111010111111111101011110111a101111222202021210111210212021200121111111111111011101011001
20210211122200211222b022221221222221111202222021111011111111101111111111001011110101111111111111111aaaaabbbababbbbabbbabaababbbbaabbbabaaaaaaaaaaaaaaaaaaaaaaaaa
12222220100000102222b2220101202101202002001121011111111101011111110111111101111011100111101011111111010122221221011122120220121222221111111111111010101110111111
11211112210112121212b0202220110211221110122002211111111111101111101101110111111111101110111011111111110120002210020221221212211212220101111111111100010110110111
20221102021202102210b1201021101212121210122220211111111101101111111011011111011111111110111101110100101021002112202112121210111020002221111100110011110011111101
12222221112222122221b2010222121211122200112202211111111111111111101011111111100111111111111111010111011111001111111111111122221111212121111100111110111111000000
22001222212212102212b2222210122112221012122022111111111111011011111101101111111111111101111111011111011110222021111201101212102212120211101100111101101111111110
22102212102112111202b2202202222222222012122202221021211111101111011111011111101001111111001111101111110120010022222202222222002122112111101101111110111110011111
22110020212122212022b1111110111101111111122112022012220111110100110100101111011111011011011110110011101122111122021112221112211111122220010111110111111110111011
02211110122221221110a1122211112100112112012202101221221011111011011110111101111aaaaaaaaaaaaaaaaaaaaaaaaaaaabaabbbbbbbaaabbaabbbbbaaaabbaaaaaaaaaaaaaaaaaaaaaaaaa
01222112212222122221b2200220102101202021202010101222021111111111010010111111111a01111011101010100011101121002212002202220221012211210111111111111111111010011001
11111111111111111010a1121122112012221011221001202211010111101110001111011100111a11101111101101110011011122122210112111200222221001021121101111101110111011101011
11101111110011111111a1112111202201222002222022211201121011111111110111110001111a111101000110110111111111110111aaaaaaaaaaaaaaaaaaaaaaaaaaaaaaaaaaaaaaaaa110111111
10111111111111110010a0021211011112112121211222201121121111111111111111111011111a111111010111111111111111111011a101111101011011101111111111111111110101a100100111
11110111110111111111a0111022200211211102012121221202211111111011001011011111111a110011110011001101111111111111a101101111111101011101101101010010111101a111101111
11111011001111101111a1102021212112212122102122211021221111111111101101111111111a011111111110111111111111110111a101111110111111111111010111011111111111a111111111
11111101101111110101a1021020122120211121221021121112111111110111001100111001111a111101110111111111001111111111a101111000111111111110010011101011111111a011111111
11111111111101111111a1011002121112212202211122012222111110101111110111011110110a110111101111110110111111111111a110111111111111101111001111111001111011a111111110
11011111111110111111aaabaabaaababbabbbbaaaaaaaabaaababaaaaaaa011111001111110111a111001111111011110011111011111a011111011101111011111111111101111111111a011111011
111101101110110001011012101121201212121122021221212002111111a111111010101111011a011111111101111011111011111010a001101101011111111111111011111111101110a110111111
111111010011011111111012101112111122221122220201012011110111a111111111101101111a101111110111101111111111111011a111101111111111111100110001110101010111a110010111
010221222221210222120222012222112120020022122222111201110111a111111111000111111a110011101111111111111111111111a101110101011111101111101011010001111001a111011111
122222212202111221211222222202212002022102201120121212011111a010111101111110111a110111111111111101101110111111a011111110111111111111101111111101111111a111010011
022102222021210121111110222221012222102110212111020212111111a101111110111101101a101111011110010111111000111111a100011000111101111111010101111111111110a101110001
111011110111111111011220112212012102121101211000211221011111a110101111111111111a010001111111111111111101111111a011111110111111110110111111111111111111a111110111
111111111111111111111111111111010111101011101111111101111101a110111111101111110a111111111111101111011101111110a111001110101111011010100111011101111111a111111110
122020111212222222221111202220212221212101100212202021101111a010101111111011101a111100111111011110011111111110a111111111111101011111111011111011111111a101111101
110221010112101111121210222222102211221110211212221212111010a100011101111111111a111111111111100111011111111111a110110111101111111111111111111011111010a011111001
121011101222111021211212222222221112222102222212202102011110a111011101111001011a101101011111011110101111101111a111111111111100101111111101110011111111a101011010
121122121120221210111212011222112022001122111221221211101011a111101101111011111a111111111111111111001111010111a110111111111111111111111110101111101111a111011111
111111122111202202211122121222022111022012112221020212111111a011110111111101111a101110111101010110110111111110a111111001111110011111110110111111101101a111111001
122201122112012111221011222022011111112110011111202212101011a111110111110111111a110111111110101111111111011111a111110101111111111111101111110111011111a111110111
222012021112221220121122020021112222001021202202222221101100a111101011011110110a111111110111110111010111111011a101101101011110111011111101110111111111a111111111
101111010000111111111002222122110222121102012202202111001111a001110101111111111a011111111111111110010111110111a011111111111011111101011110111110111001a101101111
221121212212210101100111202221222011222112212212222212111101a110101101110111111a011101110111111111110111101110a010111110111011111001111110101110111111a111011111
021100101211222102120212010202011121101122220222011211011110a011011011001111111a111011110111111111010111111110a111111110001110111111111111111110011111a011011111
212121002222011122221122222202011022020111012120111212110110a111110111010111111a110111111111100011111010110111a110001011111011111110110001111001011011a111111101
220202212022022222211212202222021012111111202102010111111001a111111011111111111a011111101111111111111110111011a111101111111011101111101011111010111111a111111111
020202202221222021021222120221111001011111111101111111111111a111101011010111101a111111111101110110111111101111a111110101111111010101011111101111011101a100110101
122202120202220022221122202202110011011111111111111011010110a110111111111111101a111101110011111101101110111101a110111111111111111101111111100110111101a011001111
111111011111111111111212201200111111111101011101110101111110a100101101110110011a111111111111111110010110001101a111111111111111111111111011011111111011a101111101
121002222222122021220222111222211111101011111011110111110011a111111111101110010a111001011111111111011001111011a101010101101111111111001011101111111101a111111111
012202222222011220201202012220211011011111011100111111110111a110110111101011111a000011101111110111101111111111a101100001111011111111011101111110111101a111011111
102222222221212122221212220212111100111111011111001011101100a110011111101111111a111101111011101111111111110111a111111111011111011111100111111101111111a111111111
111011111110111101111102122122111011110111111101111111111111a011111001111111011a101111111101111101111111011011a110111111101111111111011110111101011111a011111011
221221200202222220221202221101111011111111111110111101110111a010111111010111111a110001111101111011111111011111a110110111101111011111101111100111101101a101111110
202222022122222222221122100022011111111111110111000111110010a111111111111111001a101111111001111101110101111110a101111111111100011100011111111111011111a011101111
111101101111100111111222220200211111111111101111111111000111a111011111001111100a111111111111010110111010111110a111111110110110111110111111011111111101a101110111
221222120222210102221122222222211111010111111110111111111111a101111011111111101a110011111111110011011111111111a111111111011111111101111011110101111111a111001111
122221202012200202120222220022110101011111011111111111110101a111111111011111111aaaaaaaaaaaaaaaaaaaaa1110111111a111010111011011110011101111111011101011a111011111
202210222021102221021121122022211111111111011110100111011101a11110011101111111111111111111110011011a1111111111a101011000011111101111111011111111101101a111101111
101222222211122202201020212120210110111111111101011101101111a11111111111111101111110011111111111001a1111011110a110111101111111011111111111110101111011a111110111
211112120221121120221122112112201011111011111100111111010111a11111011010111101111111111110111101010a1111111011a111111101111101111111100110111011111111a111101101
221111220222202111221021201220211100100111111011111100111000a01011111111111111011111001110111011110a1111111101a111101001111111111111111111111110110111a100011111
212122022002012102221210212221210011101111111111111110101111a11101110111000111111111111101101111110a1111111111a111011111111111111111111111111111110111a011010011
022120220210002002001200002201001111111011111111111111111110a11110011110101011111111100111111111110a1011111100a110010101111111111111111111100011110111a011101011
211110201122110021211222121012110111111101011100101111111101a11101101110111101111111111110111011101a0011011011a110111111101110100111111101011011111101a111111111
110222120022001202020121021221011111111000111101111111110110a11111111101111002110212222211200111102b2222122211a111101110110101111111111010111110110011a111111110
222011102012010202001101012211111111000111101100011111110101a01111010111011101220221101201122111200b0202201110a111011101111101111010111111111001111111a111111111
012110122012212002211122001222110110101111111011111110101111a01011011111011112212110211201101210222a1011220211a111111101111010111111111101111111111101a110111111
212000121112122222211222012212211001110111111110100101111111a11001101101100112211011212202220121212b1200221201a111101110111111111001111110011111111110a111101011
121122222011221222110212122111211111011111101111011101011101a11101111101111101211210121212120112120a1121021211a111111111011111101111111011110111011101a111111111
111101210210212011121200010222211111111111110100111111110111a11111110101010111202102212201200021001b1110202211a001010111011001000011101110001111111101a111101111
121212220111110221121012212210211111111111111111111101110010a01101111110110111201201212021212212022b2112202111a111111111011111010111001011110111100111a110111111
112120011201101012110112022021211011011110100110111111111011a11110111110111112222110021022210110012b0112022000a110111111111111111111111101011101111101a111110111
112111211111102221000212221121211111111010101011111111110011a11111111111111012110121120200202212222b2112110101a100111111110111111111001011111100011111a101011111
222210002020222110111122211200111110101101110111110111110101a11011110110111112221211122211202121101b2122122011a011111111101011111111111111111111001101a011110101
111110110111010111111111111111100111111111001001111011111100a11011111101011101212202101112211212212b0221012010a111100111011101110111011101001111111111a100101111
111011111001011110111111111111111100110111011111011111111111a11111111011001111100120122210122220121a1211111201a111011110001111011110001111111011101011a110111111
101111111101111111110110110111101101111111111111001111111110a11111111011110110202221211222022121221b1211212211a110011111111111011111111101111101111111a111110001
111111111001001111101111111111111100111001101111111111000001a11111011111111111012112211220121202121a2211111211a110111101111111110111111111011011111111a111110111
101111011111001110110111110011110010111011011101111110011111a11111110111111112200022221101201212211b0222122011a111010101101011111101110111101011111111a100111111
111111111101111100101101111110111111101111111011111111111101a11110111111111111201211111111120012012a2211221011a11011110111111111111111111111111101111a111111111