110,141
4,141
6,63
20,84
86,112
16,29
0,30
60,104
45,38
146,20
0111011011111110111111011110011111111111111a1111110111110111110010010110111111111111101010111110111011110110110111a010111010111111101110110111111a1110111111110
1111110101111110111111110111111110101111111a1110001111110011010111101011111111110101101111111011101111110100111100a011111111111111111111111101101a01110101101011
1110100110111111011111111111110110110011011a1110111110111111111111111111111001110111101111111111001111111111111110a101111110101111111111110101101a11101011111011
1011111110011111111011100001111110011111111a1110111111111111111101111101111111111111111011111111001111011011011111a110011111110011110100111111101a10111001110111
1111101011111001110111111101111111111111111a0111110111110111111111010111111011111111111111111100101111111100110111a111111111111111011101111111111a11101111011001
1111101111111111111101110111111101100110110a1011111011011011111101111110011111111011100010110111101101111111011111a110111110111111121121112020100b21112112222222
1111111111111011011011011101110111001001111a1111110111111111111101111111111111110111110111110011011111110111111111a110111101100111002101221110122b22102221202222
1111110110111111111100111110011011110111111a1111111101011111101110111011110111111111111010111111111010110111110101a100111111111111011021111002111a01001212212122
1111111001110111110011110111111011110111111a1111110110011101100111111111100011111111111111011100111111011011011101a110000011011011121211102222002a12100011022122
1111111111001111110111111111111100111111110a1111111101111001111111111111011110101111111111100111110111110111111111a101101100111110122211200200022b22112222222110
1001111111111111110111111111101101110011011a0110110111111111111111111111010101111111101111111001110010111111011100a100111111111111101010120211112b21111122122221
1111111111110111111010111110111111111101010a1111111111110111110011111111111111111011101101111101111111100111111101a111111110111101112020202210122b22111222120012
1000111111110111100111011101111111011101111a1101111111011011111101110111111111010011111111100111100110101011011111a101110111111111111021102112111a21111122010121
1111111111101111111111011111111111111011001a1010110101111111101111111111110110111101111010111011101110111111111101a101111011111111121221012202011a22012101122222
1111111111111010011111111101111101011111111a1111111111111111111011111111111110101011011111111011101010111011110110a111010011111111121201001210120a20112122222002
2221022012222122222222112001112101111111111a0111111011010111101111101111010110101110010111111111011111111111100111a111110111001111102201121012212b12112210102210
0202222202122122011112211121221201001110000a1111111010101111111111111111110010110111011111111011011011110111111110a111101111010011100220120221211a01001222112221
2222212222222212211210110211222011110011111a0101101110111110111111111101011111111101111111111011110111101111110111a100111101110111022202102201202a11112020002221
2200020220210222122221112202211211111101111a0010111101111110111100111011111011111111100111111111111101111111111101a010010101111111122222122202121b02102211022112
2222202220220212120211221211120210111111011a1111111100011011111011111111010111111110111010011011010011111111111011a011111110110111102121211201202b22111211111222
2221122122212222012112121221200011111110011a1111111101111010110111101101111111001110111110101111011111111111111101a111110111010111122012202102212b11111222122222
1220222220122202121111122100101110111111011a0111011111111111101111011111101111101111001111111101111111111111111111a111111110011111102102210220112b22011120221202
0222122221211221211221221212011011111111101a1111111100001100011111100101111111111111101100011111111111110001001111a110011110110011100210010210112a11000222220222
1101111111110111111111111001011111011011110b1001120010120110111111101111010111111111101011111011111111111101100011a110110111111111112120112211222b21110121121211
1011111111110111110101001110112220012212112a1121201222121212010011111011110111001101111101111001010010101111011111a110110111101010122201120111020b01111221002221
2222222222122221121012021121211122212020202b0201210020021212211110111011101011101111111101110111111110101011111111a100010111111111102101201210210a12112011101112
2222002012022221221112122210212211121222022a0010112022221111201111111110101011111101101111111011101111111111111101a111111111011101112122220121221b12110101112112
0122102212122221201211212221202002210210220a0121112221021221101111110110101111111111111110110101110111111110111111a101111001111111121001220121112a22012211012122
2122221220101212021211212211222212001010211b1121122112222112111111010100111111111111110001001011101101111111111111a111111111111011122122121211121a22111211221212
2211210221022222212101220212102201112112022a2121002122122112101111001111101111010111010111111111111111111101111110a111011111111110112202210021201b22112211222222
2222222212200212202112222222020221220102201b0211100212212201111001011111110001100110001110111111111111110011111111a101111111111111012122221212120a01112122001101
2112222202122221121212111122010211112111221b2121122111110212211111011111011101111110101111101111111111111111111111a111111110111101112212112212222b22112011122210
2222222022111122221210220222120020220220211b2220102020211212211110111111111001111111011110111111011111111101110111a110111001111110122220221120202b12112112200101
1122122001202020220211010021101211211102222a0221012020021222211111111111111011111011101111111111111010111110111011a111111111100101112212122210211a12112211122012
2020222212022222221111022212012201112101212b1011102212222220210111011111111111011101010111111111011111110111011111a011100111101111110011220220201a22111011120121
1221222222222221110202212121122121221212221a1021101022121111011110011110111010111001111111111111110101111011110110a101011111011111012011222210200a21111212222112
2222222220222202121112111021122211202222022a1121222220211222211011101100111100111101111111110111101111111111101111a110111101111101011111101110011a11110110111011
2222120122021212111211222221212021022221021b1200201110122122210111101111111101011111111111111111111111010101111110a101110110110100111111011011111a11111111001011
1222201222102202220011221202111112101200021b1121222202011222011111100110110111101111111111110111011110110011111110a111111111111110111111111101111a11101011011111
1022202221222222222012222121122122011010212b1211221111101122111010011111101011111100111111100111101101011111111111a101111000111111111111111101000a01111111111101
2112222022220022112012022221222021202011122b1111211202011220110101111111111111011011110110011111111011011000101011a101101111111100111111110111100a11111100110111
1222212100120202111200011200202211110212211b0121201022210111111011111111101111111111111111001111111110010011011111a111111111101011111011011111111a10111011111110
1210120212222101201210122021110212102012102a2121022212020121201011110110111101111011011010011111111111111011111111a100111111011011111101111111001a11110100101100
1111110111111111111111111011011111011011121a1221122121112212210111011111110111110111111111011111111111111111110111a111111110111101110101111111110a00110111011111
2222222222222222221011022211222222210121012a2201120202002021211111101111111111010110111101011111111111111111111101a100111111111101111101101111111a11110110110101
1122210202010222111011011110100212212112122b1111221010101121001011110101111011100011111011111100110001010111111111a111111110111011111111110111110a11111111111111
0111011011100111111111111111110211220121100b1011112112002221211111111101111111111110011111111111111011011111101011a111011111111111101011111111111a11111111110101
1111111011111010111111011111100101120221122a2000121222200001011100101111101111011111010111111111110111111111110110a100101100110111011111101111111a11110110111110
1221211110102122222212111110111012221220120b1201112201211210010111011111110101101101111111001111101011110101001110a111011111011111001101101100010a11011111101111
2212211121122122212210111110101012211011102b2011022010221222201111111111101111110101101011101011011011111111111111a111110111111111111011011111011a11011111011111
0211222221102101220012111011111121110221111b2221112222211210211111101111111111101001111101011101011000111101010101a101110111111111111111110111111a11111111100110
2112212221121222211212011011110112210101111b2111021222101200211111111110101110111011111111111111111011111111010111a111101110111011101111110111111a11111111111010
2201102220122222220211111001012222212111122b0221112222201101211111111111011111111011111101111011010111101111111011a011111111110101111111110111111a11111111111001
2012011212122012202111111001111212201112121b2011102122111021211111110110110111111101111111111001001011101101011011a111111101111111001110111111111a10110110111111
2212122122212212212212111011111111111110111a1111111011111111111011010010111111111011101111110111110100110111111011a111101101100111111011111110111a00110110111111
0121120121021002002010100000111011111101011a1100101111101110111111011111111111110101111101100111111111110111101110a111111111011111111111111110101a01111111111011
0100211010221202202211111111101101011111001a1011011111101111011101111101111111111111011111110110101101111101111100a101101001010110111011110111111a11011111110111
0110111111020022211210111010111011111111111a1110111111111111111111101001111011111101111100111111111111111011011011a111111110100011111111111111110a10111110010111
2122111221210122110100111001111111110111111a1101111100011111110110111111111101111111010111111101111011111111111110a110011111110111111111011111011a11001111111111
aaa2021121212202211012aaaaaaaaaaaaaaaaaaaaaa1111111111111011111110001111101111110110110110111111111111111111111011a101101111111111011110111111111a11111111111000
20a2212121012101012111a1101110111111111111aaaaaaaaaaaaaaaaaaaaaaaaaaaaaaaaaaaaaaaaaa111110111111111111101101111101aaaaaaaaaaaaaaaaaaaaa0111111110a11001011101111
02b2111111022202220201a1111101111110111011a1101011110111111110101110011111101110111a11110011101010110011111011010111111101101111111011a1111011111a11111111111111
22b2220202022221000012a1111111111101101111a1100111010110110111111111111111111011001a10111101110011111110110111111101111111111110011011a0111111111a11010111111011
21b2022111220022222212a1001010011111111111a1111111101111111111010111111111101011011a11111111110011011101111110011111101011101111101011a1110111111a10010101111111
22b1101210220121112201a1001111111101111010a1110101001111110111101111001101111111011a11111111110101110111101111111111111111101111110011a1111111111a11011110111101
22b2200120210212211112a0111111011011111111a1111101010011111111111111101111010010111a10111111111111110111011100111101111110111010111101a1111111111a01110111111111
01a0122102221222220201a1101011011111110000a1011111111101111111101111111011111011110a10111111101111101101111111100011110111111101101111a1001111111a11101110011101
11a1111111101111101101a1111111111111111111a1101001011111111101111110111011101111011a11100111001101111111011110101111111101111111111111a1011111111a11111111111111
11b2011100222012012001a0111111111011011011a1001111111110011110111111110101100111111a11011111111111101100101111111101111111111011111110a1101110111a11111011111111
11b1102020202020122000b2210202202112101111a1001111111011111111111111110110010010111a11111101111111111111101011010011111110110010110111a1111110111a11100110111011
10b0122012222220120222a0222212211211111111a1111110111111110011111111111111010011111a01110111110111011101010011010111111111111110111111a1111111110a11111011111111
10b0022221220222022202b1222102211212110110a0101111101111111101101110111011110011111a11110011111110000011110110011111111111110011110101a0111111110a11111110111111
11b1202221222202222222b1122212210222111111a1111110110110111111110111111101111111011a01111100111101111101011111101111111101110100100111a0111011011a11011101111111
22a2202110220212102102b0101112120222111011a1011010111111111011110111111011110110101a11111011111101111110111111111011111011111110111011a1100011111a11111111111111
12b2122222002201221222b1121220121222111111a1111111111011101111100111101111111111111a01101111101011001111110001100111111111111101100101a1111111011a01011100110111
11b0202221222122122222b0100201112020101111a0100011111111111111101011111101001111111a11101111101111111111111111100100111111111111010111a1111011111a10110111100110
11b1102111222022220211b1222222222202111111a1111111111110111111101111111110001110101a10111110111011111110011111010111101100011010111011a1111111111a10111101110101
12b1120212222112221221a2200021121221001111a1101111101111010011111111101101110101110a10111001101111110111111111111011111111011111111011a1011111111a11111001111111
20b2102201202001222222a2012020211211111111a1111111111011111101111111111111111111001a11100111111010111111111111101101111110111111111111a1100101111a10011011011110
11aaabbbababbababaabbbb1121102222111111111a1111111111011011111111111101111111111110a11111110101111110111110110101111111101101111111111a1111110111a11110101011111
110111212221222012112212202101122221110100a0111110111011101111011111110011111111111a11011011111011111111111111101011111000111011101011a1101101011a11111111011111
101112212212010110202121221211112120011111a1011111101111111111001111111101011111011a11111111110110111111111000101111010110111111110101a1111111110a01110011111111
111111221221212221200112210011011201111111a1110110111101111111101101111011111001111a11110100111111111110111111111011101111101101111111a1111110101a11110111111111
110112000222010210102112010011101110111111a0111101111011110111111111111111111111111a01111111101011010111111101011111011110011100111101a1001001110a11110010110110
110110102222111101222011211100222202111111a1110111101010111111010111011111011111111a11101101111111100111111111111010111011110111001011a1101111011a11101011111111
101111222221121221222022102201202010111110a1111011110111111111111111111001111111011a11111111101111111111111011000010110111011111110001a1011011111a01111110111111
111110212021110111021111101102111021010111a1111100101111111110111111010111111111111a11011110110111111011110111111001100111111111111111a1111110110a11111110111110
111111110111111111000101111101111111111111a0111111111111111100111011111111101011011a00111111111111101101101111011011011110010001111111a1011011111a10011111010110
110112002222210111122120222021201112000111a1111111111011111111111111011110101110101a10111011101111111111110111100111111110111011010111a1011111011a10110111101111
111102012122112021122211010112011202100111a0011012220212210021011222122211101111111a11111010011110111101011011111111111011111111101111a1111111111a01111010111011
111012212211222121221121221210010110111111a0122012101012220211211122211120221100010a01100111111101101011101111101111111111111011111001a0111111111a01101111111110
011112211120221222210021112222012212000111a1112122220122221121210220221011211011111a11011111111111010111011111111111111100011111001111a1011111111a10111101101101
010112021222201000120211010222122112111111a1110110211121102221011212212011101111110a01111111111111111110111011111111111111110110011111a1110110111a01110111111111
011112201021112122201011112102122222110111a1111101221021221110111112120020121101010a11111111011101101111111111011111111111111111111111a1111101110a10101111111111
110102122001221022001121021212221102100111a1122112221001212111211020202210011111111a11011001111110111001001011101110111111111111011111a0111111111a11001111011111
010111111110111111111012010122221111110101a1002102121102101211101210221120221111111a11111111110111111111111111111110111111111101100111a1011111111a11111110101011
111111021102101111121221020202120112111101a1121220222211010200111020221120201011111a11010111111011111011110010111111111101101111100110a1110111110a11011101100111
111111111121022212010222220012211110111001a1022122022121122021211222011222222022211a12100002112012222111111111101111111011111101111011a0100111011a11111111111111
011102222122022021101211211011212222111011a1021221122021110121210021201122202112102a21210221121022101101000010111111111111111100100111a0111111111a00101101011111
11aaabaaaaabbababbbbaabbabbaabbbbbabaaaaaaa1122012222112010221111211010222222012012a21200021200212112111111111111111111110111111110111a1011111111a11110001101111
11a11010111111010111111011011111101110111101012001222011212221211121121202222212121a12221011111111111111110111110111111010111111011101a1111111101aaaaaaaaaaaaaaa
11a01011101111111111101001111110111111110011122122121111221111210022001212120120001b12212012221121212111111111111110111100111011111011a1111001111101111111011111
11a01011111111110111111110111101111011111010122212212020221121211022122221200222111a22000112122220211210111111110111101111010111011110a1111111111111111110111110
11a11110111101111101010110111110011111111111011222111121112021011012211211221121121b12011121001211002211011011111110111111111111110111a1111011111111111110001111
11a10101111111011101110111011111111011110111112022220111011121211201021220220011212a21110122112201102211111101111111111111111111000101a1100101111111010101110011
11a11111111111111011010111110111110110101111120211112212211210111121201222221100202b12112121202121220211100101110011111000110111101101a0110110101011111110111111
11a11111111111101111111111111111111001011101111121111210102221111221101220101221111b22112221121221220111111111101111110110101111011011a1101101101011111111011110
11a11111111101011111111011110111111111111010120212001222212221011211212202222121012a11102201121101222211011110110111110111100011111111a1101111111111101101011111
11a01011111101101111110011111111111111011111112120202102101111210002021222221002221b02121111221211122111110111111101111110111011010110a1111101101111111111111110
11a11111111111110111111111110111101110101111102121222011222120211012022222202201212b02122122222110222201011101111111111111110011110011a1111010111110001111111011
11a11111110101011111011111110010101101011111122121120102120011211210112201222021211a22220021021221212211101001101100011111011111010011a1111111011011101011111011
11a11110101101111011111111111001111111111110111202121202222211211211112222222011112b01222111121022100111111111111111111101011111111101a0101101101110011101111101
00a11111010111111111111111101111011010111111121121212212221221100200211222221121121a21011220110001222211101011111111111011001111011111a1111111111011111111110111
11a11011111101111010111111111111111111111111110221210110210210211112211112221122210b22120110211021100211111111111111111011111111011111a1111111111111111011011111
11a01111110101110101111111111111100111011111121010110110212100201111222222200200122a21021012012222201011110111101110101010111111111110a1011101101101111111011101
01a10111111111011111111110111100100011111011122111121222012021210212211222010112121a21021022102220121201100101110111110111101111111011a0111111111101001101111011
10a10011110111101101110101111001101101110001100211112201212221201210022110222212222b22222111112211212111111011111111111111111111110101a1110101011111111010011111
01a11100111111011111111111111111111111111101112110001211112110010212221201022112102b12222221021201122201011111111011111011111110111111a1111111101111010111111111
11a11111100111111111111110101011111101111111021212100121220221111122122222121110101b21121221122221122111110111110001101111101111001111a1100111011111111111110101
00a11110111111101010101101111101101111001111121221112220202220211210221222021222111b01002012121220211111010111010101011111111111111110a101111110111111111001101